
	  NO		 ./textures/no_tex.xpm

		EA 		./textures/ea_tex.xpm		
    WE         ./textures/we_tex.xpm
  SO    ./textures/so_tex.xpm








C 155,179,8
F 245,230,,,,,, 120






11111111111111111111111111111
10000000000000000000000000001
10000000000000000000000000001
10000000000000000000000000001
10000000000000000000000000001
10000000000000000000000000001
10000000000000000000000000001
10000000000000000000000000001
10000000000000000000000000001
10001000000000000000000000N01
10000000000000000000000000001
10000000000000000000000000001
10000000000000000000000000001
10000000000000000000000000001
11111111111111111111111111111
10010000000000011000000100001
10000000000000001101010010001
11111111111111111111111111111
        


