  
	 NO		 ./textures/hrusch1.xpm

		EA 		./textures/hrusch2.xpm			      
    WE         ./textures/hrusch3.xpm
  SO    ./textures/hrusch4.xpm

		F 			34,32,28
    C           50, 50, 50

    111111111111111111111
    11000000000000000011111        
  111000011100111100101 10111
    11111111101  11110111111      
            111111  101
                    101
11111111111111111111101111111111    11111
1000000000000000111010111110000111111111
11110111111111101110000000000001001
111101 1111 11100000000000000001001
11110111 11111011101010010101111111
1100000111010101110000010101                1
10000001 100000000000000W111             111 1
1000000111000000110101001101111             1
11000000000111011111011111011
1111011111111101 101111010001
11111111 111 111 11111111111